33333333333222222222222222222222
33300000013222222222222222222222
30000000003222222222222222222222
30300000003222222223222222022222
33300000003222222223322222002222
33300000003333333333322220100222
33311111111100000222222222102222
33300000000111111102222222200022
33000000000000000112222222222222
33000300000000000010222222222222
33333303000000000013322222222222
33333330000000000311112222222222
33333300000000000333311222222222
33333330030000000333001222222222
33333333000330000000001222222222
33333333333000001111111111122000
33333333333000301000100000122020
33333333333303300000100000120000
00000033022200000000110011120300
00000030322200000000000000120330
00000303002220000000022000123330
00000300332222222002202022123330
00000000300032220202022221123300
00000000033033322222222222233300
00000003003000300222202333333300
00000000000333030220222233330300
00000030303000333300232223330000
00000000000000000020233333300000
00000000000000000000330330000000
00000000000000000000000000000000
00000000000000000000000000000000
00000000000000000000000000000000