********************************
********************************
********************************
********************************
********************************
**********2*********************
*******222****1*****************
***************1****************
********************************
************************2*******
**************11****************
***************1**********2*****
**************1*****2***********
**************11****************
********************2****2******
***************1*****2**********
******************12************
*********11*******1******2******
*********1*1*1*1*********22*****
***************1**1**22***2*****
**********************2*********
******************1*******2*****
*********11**1**1*21************
*****************2**2*2**2******
********************2***********
*********************2**2***2***
***************2*******2**2*****
******************2****2********
*****************22*2***2*2*****
*******************2****22**2***
******************2**2***2******
********************************